//MAP CONVERTED BY dmm2tgm.py THIS HEADER COMMENT PREVENTS RECONVERSION, DO NOT REMOVE
"a" = (
/turf/simulated/wall/iron,
/area/f13/wasteland)
"b" = (
/turf/simulated/floor/grass,
/area/f13/wasteland)
"e" = (
/turf/simulated/planet_edge,
/area/f13/wasteland)
"f" = (
/turf/simulated/mineral/random/high_chance,
/area/f13/underground/cave)
"k" = (
/turf/simulated/floor/wasteland,
/area/f13/wasteland)
"n" = (
/turf/simulated/floor/exoplanet/desert,
/area/f13/building/village)
"o" = (
/turf/simulated/wall/r_wall,
/area/f13/building)
"p" = (
/turf/simulated/floor/exoplanet/desert,
/area/f13/builidng/city)
"t" = (
/obj/spawner/armor_parts,
/turf/simulated/floor/exoplanet/desert,
/area/f13/wasteland)
"y" = (
/turf/simulated/floor/road{
	icon_state = "horizontaltopbordertop0"
	},
/area/f13/wasteland)
"z" = (
/turf/simulated/floor/exoplanet/desert,
/area/f13/building)
"A" = (
/turf/simulated/floor/exoplanet/desert,
/area/f13/wasteland/forest)
"B" = (
/turf/simulated/floor/road{
	icon_state = "innermiddle"
	},
/area/f13/wasteland)
"C" = (
/obj/landmark/join/start/wastelander,
/turf/simulated/floor/exoplanet/desert,
/area/f13/wasteland)
"D" = (
/turf/simulated/floor/exoplanet/desert,
/area/f13/wasteland)
"F" = (
/turf/space,
/area/space)
"H" = (
/turf/simulated/floor/exoplanet/desert,
/area/f13/wasteland/ruins)
"I" = (
/turf/simulated/floor/exoplanet/desert,
/area/f13/ncr)
"J" = (
/turf/simulated/floor/exoplanet/desert,
/area/f13/tunnel)
"K" = (
/obj/spawner/ammo,
/turf/simulated/floor/exoplanet/desert,
/area/f13/wasteland)
"L" = (
/obj/vehicle/train/cargo/engine,
/turf/simulated/floor/exoplanet/desert,
/area/f13/wasteland)
"M" = (
/turf/simulated/wall/sandstone,
/area/f13/building)
"N" = (
/turf/simulated/floor/wood,
/area/f13/building)
"O" = (
/turf/simulated/floor/tiled,
/area/f13/building)
"P" = (
/turf/simulated/floor/exoplanet/desert,
/area/f13/sewer)
"Q" = (
/turf/simulated/floor/exoplanet/desert,
/area/f13/underground/cave)
"S" = (
/turf/simulated/floor/exoplanet/water/shallow,
/area/f13/wasteland)
"T" = (
/obj/vehicle/train/cargo/trolley,
/turf/simulated/floor/exoplanet/desert,
/area/f13/wasteland)
"U" = (
/turf/simulated/floor/exoplanet/desert,
/area/f13/legion)
"V" = (
/turf/simulated/floor/exoplanet/desert,
/area/f13/subway)
"Z" = (
/turf/simulated/floor/exoplanet/desert,
/area/f13/wasteland/radiation)

(1,1,1) = {"
a
e
e
e
e
e
e
e
e
e
e
e
e
e
e
e
e
e
e
e
e
e
e
e
e
e
e
e
e
e
e
e
e
e
e
e
e
e
e
a
"}
(2,1,1) = {"
a
D
D
D
D
D
D
D
D
D
D
D
D
D
D
D
D
D
D
D
D
D
D
D
D
D
y
B
B
D
D
D
D
D
D
n
n
n
n
a
"}
(3,1,1) = {"
a
Z
Z
Z
Z
D
D
D
D
D
D
D
D
D
D
D
D
D
D
D
D
D
D
D
D
D
y
B
B
D
D
D
D
D
D
n
n
n
n
a
"}
(4,1,1) = {"
a
Z
Z
Z
Z
D
D
D
D
D
D
D
D
b
b
D
D
D
D
D
D
D
D
D
D
D
y
B
B
D
D
D
D
D
D
n
n
n
n
a
"}
(5,1,1) = {"
a
Z
Z
Z
Z
D
D
D
D
D
D
b
b
b
b
D
D
t
D
D
D
D
D
D
D
D
y
B
B
D
D
D
D
D
D
n
n
n
n
a
"}
(6,1,1) = {"
a
Z
Z
Z
Z
D
D
D
D
D
D
D
b
b
b
D
D
D
D
D
D
D
D
D
D
D
y
B
B
D
D
D
D
D
D
n
n
n
n
a
"}
(7,1,1) = {"
a
Z
Z
Z
Z
D
D
D
D
D
D
D
D
D
D
D
D
D
D
D
D
D
D
D
D
D
y
B
B
D
D
D
D
D
D
D
D
D
D
a
"}
(8,1,1) = {"
a
k
D
D
D
D
D
D
D
D
D
D
D
D
D
D
D
D
D
D
D
D
D
D
D
D
y
B
B
D
D
D
D
D
D
J
J
J
J
a
"}
(9,1,1) = {"
a
A
A
A
A
D
D
D
D
D
D
D
D
D
D
D
D
D
D
D
D
D
D
D
D
D
y
B
B
D
D
D
D
D
D
J
J
J
J
a
"}
(10,1,1) = {"
a
A
A
A
A
D
D
D
D
D
D
S
S
S
D
D
D
D
D
D
D
D
D
D
D
D
y
B
B
D
D
D
D
D
D
J
J
J
J
a
"}
(11,1,1) = {"
a
A
A
A
A
D
D
D
D
D
S
S
S
S
S
D
D
D
K
D
D
D
D
D
D
D
y
B
B
D
D
D
D
D
D
J
J
J
J
a
"}
(12,1,1) = {"
a
A
A
A
A
k
k
k
k
D
D
S
S
S
S
D
D
D
t
D
D
D
D
D
D
D
y
B
B
D
D
D
D
D
D
J
J
J
J
a
"}
(13,1,1) = {"
a
A
A
A
A
k
k
k
k
D
D
D
S
S
D
D
D
D
C
D
D
D
D
D
D
D
y
B
B
D
D
D
D
D
D
D
D
D
D
a
"}
(14,1,1) = {"
a
D
D
D
D
k
k
k
k
k
D
D
D
D
D
D
D
D
C
D
D
D
D
D
D
D
y
B
B
D
D
D
D
D
D
I
I
I
I
a
"}
(15,1,1) = {"
a
H
H
H
H
k
k
k
k
D
D
D
D
D
D
D
D
D
D
D
T
D
D
D
D
D
y
B
B
D
D
D
D
D
D
I
I
I
I
a
"}
(16,1,1) = {"
a
H
H
H
H
k
k
k
k
D
D
D
D
D
D
D
D
D
D
D
T
D
D
D
D
D
y
B
B
D
D
D
D
D
D
I
I
I
I
a
"}
(17,1,1) = {"
a
H
H
H
H
k
k
k
k
M
M
M
z
M
M
D
D
D
D
D
T
D
D
D
D
D
y
B
B
D
D
D
D
D
D
I
I
I
I
a
"}
(18,1,1) = {"
a
H
H
H
H
k
k
k
k
M
N
N
N
N
M
D
D
D
D
D
L
D
D
D
D
D
y
B
B
D
D
D
D
D
D
I
I
I
I
a
"}
(19,1,1) = {"
a
H
H
H
H
k
k
k
k
M
N
N
N
N
M
D
D
D
D
D
D
D
D
D
D
D
y
B
B
D
D
D
D
D
D
D
D
D
D
a
"}
(20,1,1) = {"
a
H
H
H
H
k
k
k
k
M
N
N
N
N
M
D
D
D
D
D
D
D
D
D
D
D
y
B
B
D
D
D
D
D
D
U
U
U
U
a
"}
(21,1,1) = {"
a
D
D
D
D
k
k
k
k
M
N
N
N
N
M
D
D
D
D
D
D
D
D
D
D
D
y
B
B
D
D
D
D
D
D
U
U
U
U
a
"}
(22,1,1) = {"
a
D
D
D
D
k
k
k
k
M
o
O
O
o
M
D
D
D
D
D
D
D
D
D
D
D
y
B
B
D
D
D
D
D
D
U
U
U
U
a
"}
(23,1,1) = {"
a
Q
D
D
D
k
k
k
k
D
o
O
O
o
D
D
D
D
D
D
D
D
D
D
D
D
y
B
B
D
D
D
D
D
D
U
U
U
U
a
"}
(24,1,1) = {"
a
f
Q
Q
D
k
k
k
k
D
o
o
o
o
D
D
D
D
D
D
D
D
D
D
D
D
y
B
B
D
D
D
D
D
D
U
U
U
U
a
"}
(25,1,1) = {"
a
f
f
f
Q
k
k
k
k
D
D
D
D
D
D
D
D
D
D
D
D
D
D
D
D
D
y
B
B
D
D
D
D
D
D
D
D
D
D
a
"}
(26,1,1) = {"
a
f
f
f
f
Q
D
D
D
D
p
p
p
p
D
D
D
D
D
D
D
D
D
D
D
D
y
B
B
D
D
D
D
D
D
P
P
P
P
a
"}
(27,1,1) = {"
a
f
f
f
f
f
Q
D
D
D
p
p
p
p
D
D
D
D
D
D
D
D
D
D
D
D
y
B
B
D
D
D
D
D
D
P
P
P
P
a
"}
(28,1,1) = {"
a
f
f
f
f
f
f
Q
D
D
p
p
p
p
D
D
D
D
D
D
D
D
D
D
D
D
y
B
B
D
D
D
D
D
D
P
P
P
P
a
"}
(29,1,1) = {"
a
f
f
f
f
f
f
Q
D
D
D
D
D
D
D
D
D
D
D
D
D
D
D
D
D
D
y
B
B
D
D
D
D
D
D
P
P
P
P
a
"}
(30,1,1) = {"
a
f
f
f
f
f
f
f
Q
Q
Q
D
D
D
D
D
D
D
D
D
D
D
D
D
D
D
y
B
B
D
D
D
D
D
D
P
P
P
P
a
"}
(31,1,1) = {"
a
f
f
f
f
f
f
f
Q
f
f
Q
D
D
D
D
D
D
D
D
D
D
D
D
D
D
y
B
B
D
D
D
D
D
D
D
D
D
D
a
"}
(32,1,1) = {"
a
f
f
f
f
f
f
f
f
f
f
f
Q
D
D
D
D
D
D
D
D
D
D
D
D
D
y
B
B
D
D
D
D
D
D
V
V
V
V
a
"}
(33,1,1) = {"
a
f
f
f
f
f
f
f
f
f
f
f
Q
D
D
D
D
D
D
D
D
D
D
D
D
D
y
B
B
D
D
D
D
D
D
V
V
V
V
a
"}
(34,1,1) = {"
a
f
f
f
f
f
f
f
f
f
f
f
Q
D
D
D
D
D
D
D
D
D
D
D
D
D
y
B
B
D
D
D
D
D
D
V
V
V
V
a
"}
(35,1,1) = {"
a
f
f
f
f
f
f
f
Q
f
f
f
Q
D
D
D
D
D
D
D
D
D
D
D
D
D
y
B
B
D
D
D
D
D
D
V
V
V
V
a
"}
(36,1,1) = {"
a
f
f
f
f
f
f
f
Q
Q
f
Q
D
D
D
D
D
D
D
D
D
D
D
D
D
D
y
B
B
D
D
D
D
D
D
V
V
V
V
a
"}
(37,1,1) = {"
a
f
f
f
f
f
f
Q
D
D
Q
D
D
D
D
D
D
D
D
D
D
D
D
D
D
D
y
B
B
D
D
D
D
D
D
D
D
D
D
a
"}
(38,1,1) = {"
a
f
f
f
f
f
Q
D
D
D
D
D
D
D
D
D
D
D
D
D
D
D
D
D
D
D
y
B
B
D
D
D
D
D
D
D
D
D
D
a
"}
(39,1,1) = {"
a
f
f
f
f
Q
D
D
D
D
D
D
D
D
D
D
D
D
D
D
D
D
D
D
D
D
y
B
B
D
D
D
D
D
D
D
D
D
D
a
"}
(40,1,1) = {"
a
e
e
e
e
e
e
e
e
e
e
e
e
e
e
e
e
e
e
e
e
e
e
e
e
e
e
e
e
e
e
e
e
e
e
e
e
e
e
a
"}

(1,1,2) = {"
F
F
F
F
F
F
F
F
F
F
F
F
F
F
F
F
F
F
F
F
F
F
F
F
F
F
F
F
F
F
F
F
F
F
F
F
F
F
F
F
"}
(2,1,2) = {"
F
F
F
F
F
F
F
F
F
F
F
F
F
F
F
F
F
F
F
F
F
F
F
F
F
F
F
F
F
F
F
F
F
F
F
F
F
F
F
F
"}
(3,1,2) = {"
F
F
F
F
F
F
F
F
F
F
F
F
F
F
F
F
F
F
F
F
F
F
F
F
F
F
F
F
F
F
F
F
F
F
F
F
F
F
F
F
"}
(4,1,2) = {"
F
F
F
F
F
F
F
F
F
F
F
F
F
F
F
F
F
F
F
F
F
F
F
F
F
F
F
F
F
F
F
F
F
F
F
F
F
F
F
F
"}
(5,1,2) = {"
F
F
F
F
F
F
F
F
F
F
F
F
F
F
F
F
F
F
F
F
F
F
F
F
F
F
F
F
F
F
F
F
F
F
F
F
F
F
F
F
"}
(6,1,2) = {"
F
F
F
F
F
F
F
F
F
F
F
F
F
F
F
F
F
F
F
F
F
F
F
F
F
F
F
F
F
F
F
F
F
F
F
F
F
F
F
F
"}
(7,1,2) = {"
F
F
F
F
F
F
F
F
F
F
F
F
F
F
F
F
F
F
F
F
F
F
F
F
F
F
F
F
F
F
F
F
F
F
F
F
F
F
F
F
"}
(8,1,2) = {"
F
F
F
F
F
F
F
F
F
F
F
F
F
F
F
F
F
F
F
F
F
F
F
F
F
F
F
F
F
F
F
F
F
F
F
F
F
F
F
F
"}
(9,1,2) = {"
F
F
F
F
F
F
F
F
F
F
F
F
F
F
F
F
F
F
F
F
F
F
F
F
F
F
F
F
F
F
F
F
F
F
F
F
F
F
F
F
"}
(10,1,2) = {"
F
F
F
F
F
F
F
F
F
F
F
F
F
F
F
F
F
F
F
F
F
F
F
F
F
F
F
F
F
F
F
F
F
F
F
F
F
F
F
F
"}
(11,1,2) = {"
F
F
F
F
F
F
F
F
F
F
F
F
F
F
F
F
F
F
F
F
F
F
F
F
F
F
F
F
F
F
F
F
F
F
F
F
F
F
F
F
"}
(12,1,2) = {"
F
F
F
F
F
F
F
F
F
F
F
F
F
F
F
F
F
F
F
F
F
F
F
F
F
F
F
F
F
F
F
F
F
F
F
F
F
F
F
F
"}
(13,1,2) = {"
F
F
F
F
F
F
F
F
F
F
F
F
F
F
F
F
F
F
F
F
F
F
F
F
F
F
F
F
F
F
F
F
F
F
F
F
F
F
F
F
"}
(14,1,2) = {"
F
F
F
F
F
F
F
F
F
F
F
F
F
F
F
F
F
F
F
F
F
F
F
F
F
F
F
F
F
F
F
F
F
F
F
F
F
F
F
F
"}
(15,1,2) = {"
F
F
F
F
F
F
F
F
F
F
F
F
F
F
F
F
F
F
F
F
F
F
F
F
F
F
F
F
F
F
F
F
F
F
F
F
F
F
F
F
"}
(16,1,2) = {"
F
F
F
F
F
F
F
F
F
F
F
F
F
F
F
F
F
F
F
F
F
F
F
F
F
F
F
F
F
F
F
F
F
F
F
F
F
F
F
F
"}
(17,1,2) = {"
F
F
F
F
F
F
F
F
F
F
F
F
F
F
F
F
F
F
F
F
F
F
F
F
F
F
F
F
F
F
F
F
F
F
F
F
F
F
F
F
"}
(18,1,2) = {"
F
F
F
F
F
F
F
F
F
F
F
F
F
F
F
F
F
F
F
F
F
F
F
F
F
F
F
F
F
F
F
F
F
F
F
F
F
F
F
F
"}
(19,1,2) = {"
F
F
F
F
F
F
F
F
F
F
F
F
F
F
F
F
F
F
F
F
F
F
F
F
F
F
F
F
F
F
F
F
F
F
F
F
F
F
F
F
"}
(20,1,2) = {"
F
F
F
F
F
F
F
F
F
F
F
F
F
F
F
F
F
F
F
F
F
F
F
F
F
F
F
F
F
F
F
F
F
F
F
F
F
F
F
F
"}
(21,1,2) = {"
F
F
F
F
F
F
F
F
F
F
F
F
F
F
F
F
F
F
F
F
F
F
F
F
F
F
F
F
F
F
F
F
F
F
F
F
F
F
F
F
"}
(22,1,2) = {"
F
F
F
F
F
F
F
F
F
F
F
F
F
F
F
F
F
F
F
F
F
F
F
F
F
F
F
F
F
F
F
F
F
F
F
F
F
F
F
F
"}
(23,1,2) = {"
F
F
F
F
F
F
F
F
F
F
F
F
F
F
F
F
F
F
F
F
F
F
F
F
F
F
F
F
F
F
F
F
F
F
F
F
F
F
F
F
"}
(24,1,2) = {"
F
F
F
F
F
F
F
F
F
F
F
F
F
F
F
F
F
F
F
F
F
F
F
F
F
F
F
F
F
F
F
F
F
F
F
F
F
F
F
F
"}
(25,1,2) = {"
F
F
F
F
F
F
F
F
F
F
F
F
F
F
F
F
F
F
F
F
F
F
F
F
F
F
F
F
F
F
F
F
F
F
F
F
F
F
F
F
"}
(26,1,2) = {"
F
F
F
F
F
F
F
F
F
F
F
F
F
F
F
F
F
F
F
F
F
F
F
F
F
F
F
F
F
F
F
F
F
F
F
F
F
F
F
F
"}
(27,1,2) = {"
F
F
F
F
F
F
F
F
F
F
F
F
F
F
F
F
F
F
F
F
F
F
F
F
F
F
F
F
F
F
F
F
F
F
F
F
F
F
F
F
"}
(28,1,2) = {"
F
F
F
F
F
F
F
F
F
F
F
F
F
F
F
F
F
F
F
F
F
F
F
F
F
F
F
F
F
F
F
F
F
F
F
F
F
F
F
F
"}
(29,1,2) = {"
F
F
F
F
F
F
F
F
F
F
F
F
F
F
F
F
F
F
F
F
F
F
F
F
F
F
F
F
F
F
F
F
F
F
F
F
F
F
F
F
"}
(30,1,2) = {"
F
F
F
F
F
F
F
F
F
F
F
F
F
F
F
F
F
F
F
F
F
F
F
F
F
F
F
F
F
F
F
F
F
F
F
F
F
F
F
F
"}
(31,1,2) = {"
F
F
F
F
F
F
F
F
F
F
F
F
F
F
F
F
F
F
F
F
F
F
F
F
F
F
F
F
F
F
F
F
F
F
F
F
F
F
F
F
"}
(32,1,2) = {"
F
F
F
F
F
F
F
F
F
F
F
F
F
F
F
F
F
F
F
F
F
F
F
F
F
F
F
F
F
F
F
F
F
F
F
F
F
F
F
F
"}
(33,1,2) = {"
F
F
F
F
F
F
F
F
F
F
F
F
F
F
F
F
F
F
F
F
F
F
F
F
F
F
F
F
F
F
F
F
F
F
F
F
F
F
F
F
"}
(34,1,2) = {"
F
F
F
F
F
F
F
F
F
F
F
F
F
F
F
F
F
F
F
F
F
F
F
F
F
F
F
F
F
F
F
F
F
F
F
F
F
F
F
F
"}
(35,1,2) = {"
F
F
F
F
F
F
F
F
F
F
F
F
F
F
F
F
F
F
F
F
F
F
F
F
F
F
F
F
F
F
F
F
F
F
F
F
F
F
F
F
"}
(36,1,2) = {"
F
F
F
F
F
F
F
F
F
F
F
F
F
F
F
F
F
F
F
F
F
F
F
F
F
F
F
F
F
F
F
F
F
F
F
F
F
F
F
F
"}
(37,1,2) = {"
F
F
F
F
F
F
F
F
F
F
F
F
F
F
F
F
F
F
F
F
F
F
F
F
F
F
F
F
F
F
F
F
F
F
F
F
F
F
F
F
"}
(38,1,2) = {"
F
F
F
F
F
F
F
F
F
F
F
F
F
F
F
F
F
F
F
F
F
F
F
F
F
F
F
F
F
F
F
F
F
F
F
F
F
F
F
F
"}
(39,1,2) = {"
F
F
F
F
F
F
F
F
F
F
F
F
F
F
F
F
F
F
F
F
F
F
F
F
F
F
F
F
F
F
F
F
F
F
F
F
F
F
F
F
"}
(40,1,2) = {"
F
F
F
F
F
F
F
F
F
F
F
F
F
F
F
F
F
F
F
F
F
F
F
F
F
F
F
F
F
F
F
F
F
F
F
F
F
F
F
F
"}
